NO     ./textures/bluestone.xpm   
SO ./textures/greystone.xpm
F  38,   26,  0   


WE      ./textures/colorstone.xpm
EA   ./textures/redbrick.xpm


C -6, 134, 100



        1111111111111111111111111
        1000000000000000000000001
        1011000001110000000000001
   1    1111111111100111111111111
   1              1001
   1    1111111111100111111111111
   1    1001000000000000000000001
111111111011000001110000000000001
100000000000000001110111111111111
111100000000000111011100000000001
111100000000001110101000000111111
11000000W000000011100010000001
10000000000000001100000010001
100000000000000000000000100001
110000011101010111110110000101
11110111 1110101 1011110100001
11111 111 1111111 111111111111
